s      #   #   ####   #    ######    ##      #    #  #
#####  # # # # #### # #  #      #         #  #    #  #
       # # # #      #         #     ##    #  #  # #  #
  ###### # # ############   #    #        #  #  # #  #
         # #    #             #           #  #  # #  #
########## ###  #   #  ###  ##### ##      #  #  # #  #
         #      #  #  #            #####  #  #  #    #
 ################  # #                  ###########  #
                     #    ###############            #
#############  #######                     ###########
                        ###########                  #
   ############################       ############   #                     
                            ###############          #
####################          #      #        ########
                              #  #   #               #
   #########################  #  #   #############   #
                                 #                   #
########  #############          #####################
                #   # #  ####                        #
#############   #   # #  #     ###################   #
                    # #  #  #               #    #   #
   ################## #  #  ##############  #  # #   #
                      #  #  #               #  # #   #
#######################  #  ##########  #####  # #####
                                               #     x
######################################################